######################
# S         #        #
# #####  #######  #  #
# #        #      #  #
# #  #######  #   #  #
# ## #        #   #  #
#       #  #  #   #  #
# ##########  #####  #
#      #      #     X#
######################
